19
.....#.#...#.....#.
.###.#.#.###.#.###.
.#.......#...#.#...
##.###.###.#######.
...#...#...#.#.....
.###.#.#.###.#.###.
.#...#.#.....#.#...
##.###.#.#.###.#.##
...#...#.#.#.#.#.#.
.#####.###.#.#.###.
...#.......#.....#.
.#.#####.###.#####.
.#.#.#.#...........
##.#.#.###.########
.#.#...#...#.......
.#####.#.#.###.####
...#.....#.....#...
.###.#####.###.###.
.......#...#.......